111111111111111111111111111111111111111111
111000110C000001100000001100M00110C0000101
1100010011001000001000C0001E00000010001001
1100010100000C1011101100001101010000100001
10000CC011110C00011010100000C1000010000001
1110101101000000011C1000000010110011010011
111000000001101110011000110100011100000C11
10C00110000100000000C000110000001010010111
100010001100MC1000111000000010010101000011
100010010000000100000000100000000100000111
100000001101000110C10001000001010000111101
1000100001110C1010010000001000000M0C000011
110001111010101001001010001000001110000011
1C000100001010M000001100101000C001M1000001
10C101001110M000101000000101000C0C00001001
1000010M10C110000100011001100000C1100100C1
1C0000001011000000111000C101001010101110M1
100M00100110C01010010000010010001001010001
101101010101000100000110100000110C00C01001
110101000000010000010001001011110100100C01
101111100100100000100101101001010001110001
11001100000000000100C010111100110100101001
10100000100C0010000C0100000001110101000001
1CC0C00001010000011M0100M0100C001010000111
1C000110110100001000001110C010000000000001
1101001010M1110100110110100010011000100111
1C1000100011000100000100000101000010100011
110111010011100001011000110000C10000001011
10000000001101001P000001001C00000000000001
10000000C00000010011010100000110000C000011
1110001000100100001110000000011100000011C1
11001000001011001C1101000100001C0000100001
100001000000C011010001C01C1010001000100111
1100C0110C0C000000110010101001010C00000001
110M00001100111100000000100001011011010101
111111111111111111111111111111111111111111