111111111111111111111111111111111111111111111111
1001000M0C00000C00010011001000100110110001101011
1001100000001000M0101000111110010000001000010001
100000C010100010000100001001010000100C0C1000C101
110011C0001000C000100000001100110000000110000001
10000001C01100010000C0001011P0010001CC0000000001
10C011000001000000001100001000101000000010000011
10000000M000100000100010001010010000011000C00111
100100010000000110010000100001011010000010000101
11101100000C0101101010000101110C0C00111010010001
1C100000001000111000110110111001000000010001C001
100000010010111100010000010010001010010001000011
110101100C1100000001M00011M0001100110000M0001001
101100110110001000001000010C011000C0010000100011
1110000110111101101110000001100C010000101C000001
11100011001001001100101000C0000110000100C1001101
101000001011000001000011000010010001100000001001
110000000000100010100110000010011100000000111101
110000001001000100C100010001000111001000011C1111
10010011C11000C0001001000000001001C1M0C111011011
111001011000000000000010000C00001001000000000001
100001001111100011001011000000C10001C00000100101
111000101000E10101110010000100001100C01001010011
111000010101000010001C1010M0100C0000000000001C01
11100000000010001C0001010000000000010C01000M1001
100100M00110010000110C00000110001000001111100101
1010011100111000M11000100000100100010000000C0011
100C0C00011111101111000001001010100101010MC00011
11001M1C0000010000011110100111000010101100101101
110000011101001001100000000110100C01000CC010C001
10011101M101C00110100110110111C10010100000000001
100000C01001C11000010010100000000001C01011010011
111111111111111111111111111111111111111111111111