1111111111111111111111111111
10010CC0100001010010000C0101
1010100111010000111000100C11
100M100000001111111101100001
1001100000011000000101000001
1110000001011000001011011C11
10000010000000100C0101101111
1000100000100010000110001M01
1010010001101M00100000101101
1M00000010001101100100001111
10001001C1001100100000110011
10010011010011PC000010000011
11001C0CC0100M10001010000101
11000000000111111010001C0001
1011011010100100000011C01101
1001100101101C101C0011000001
1000000C01011000100100000001
1001001101100000C000000C0101
100000011C001010100001010101
1C00C01100000000000001000001
1000001100000000110010001101
11M0E10100M00010110000C00011
101000111011010C001000100001
10C1101110100010000000100011
1100000110011011000001000011
10100001C1001000C011010000M1
10000000101110C001000010C111
1001000000001100000000001001
101010010101010C011001010101
100100C100000010010000000001
1000011C00010011001010100001
100000011000001C000001100001
1111111111111111111111111111