1111111111111111111111111111111111111111111111
11000100001101C0000101000000011000111001100001
100100M00110000C11100100001000000100100C110001
1000001C0C0001011100010100000010000000010100C1
1100000010100100100001000010000000110100001001
10001100001001000100M0000001100001100000100001
1000000000000010110001000000110C1100000100C0C1
11101000010000010001C0001001001010001100100001
1010100001001000M100010C0100000110000010001101
10000101000000C000100000001100001010000101C001
10010C00001C010010M011000000110100010C00000101
100010011C100010001000110000010000011010001001
1011001000001100100010001101001010100011100011
1000010000M011100000001110010000C1000001101011
10010011010P00011000000010000011011000M0110011
111011000101000010100010M011C10000C00010100111
10001101001101001100000111110001000110011010C1
11001101111010100010000100100011C00100001C1001
100010C1C1000000001010111011100111100000000001
1101100M1000000000M00010110CC010010011C0100011
11C10C00000C111010C0010C0010011101000000001011
1000101010100001001000011C01100100000010000001
10M010011000010011010100001C101100100C01100001
10C110010C01000001000000110000110000001C000011
100100101000010010010100000111M0100101C0111011
10010100M10010C00000000000010101000000011C0001
100M100111111101000001101C100000000100C0000001
1100000000011C1000C0101M0100000000C11C10101111
1001011001010010101000000000000000001100010011
1001110010001100000100010101010000010110110011
101001010001000011C1000100101000000C1001010001
1C110C0C10010101010000000100000000000100000001
1000000000M01C00000001000001010100001011000001
1000101010C1000000011011C0011100011C0101001111
100010110000110M000011C0101C110C00100100100001
10001100M001001101C01100010000CC0100E100010101
11001000000010001000C0000C0001100100010000C011
101110001101010010100000000001C100001C00100001
10101101010100010101C0100001100010101011011001
1001001011000C00010010100011001M001000000C0011
1010011010000100100000001010100001100000100011
11000101111C1010000011000101001100001100000001
1111111111111111111111111111111111111111111111