11111111111111111111111111111111111111111111111111
11001010C11110001110100101000010101000100100001001
10000001111110001010001101011100100100001101000011
100110010010C0001010C0000100101001000001010000M001
11C000C000100100011000010001101100100C000010001011
10C0001100001M000000010011101C11100001110100010001
100001001110000000C01000000C10000001010000C1011C11
100C10100000011101M001C010000011011000000111000011
1C110011000000000101C000110000000100C0000001010111
11100000110000111000000000000010011110010100000001
101101000C100010111100000000000100001100110C001011
10001000001C000000001011001010000111C1101001000101
100110100E00101000001010010001C0110000M00010000011
1000C1001010010110C001C0101C000000000010110M010001
11100110C0001011C100C0000100010C110000011000010101
11000001000000011110100001110000010101100111000001
11000100010001010110010C000100010001C0111001010101
1000110C000010110000110011000010100000110010000001
10100100001100101000110010001010MC0001000000110001
1000100000010000110110000M1C0011001000101101101111
10010000000000010CC0010010001011001100100010000001
1C00000010110000101001M00C000000111001010010000001
1C0100001011101010000000110C00001000010000M0000101
1001100011010C0000010M000101100100001000000000C001
100110000011100CC001001011000010001010001001100101
11001010010100001M00100000110000001000C00000111C01
10101000M0000001000000100101000C01CC01001001101011
10000001011010C0000010100101110100P000000000000001
11111111111111111111111111111111111111111111111111