1111111111111111111111111111
1001M000010001010C01C1001001
1101101110011101011100101011
100C10000P1100010000MC011001
1M000111000000C000C010001001
1100100001101100CCC110010001
111C00001000C00000100000M001
1001010110100100001100001011
10110100CC010000100011001111
110100C010000110000000001101
101100C01100011M000001010001
100111110100011000C1C1010011
10000110100001011C00C0001M01
1000011101101100110001011101
10000000C001C101000101001111
1011000000010100000000001001
100000100010101000C0101011C1
10111010110010C1010001000111
10001000001000110001C0011001
1000110001100C00000001111001
1000001010101000000000000101
1011C01011000001101000000001
1000000100110001010001000001
1000101101001100100000000001
100010000011100000C000000101
110101000010000000000100M101
1000110000011000000011011111
1100000101000010011010000001
11100001100100010100000C1111
1111011000001111100000000101
1001000000000C10001010001001
1010000000M01000100100001011
1110000111C00010011100010101
10001000000010010C0000110011
101000000000100010010001M111
1010001000100000011000101001
1111111000010000000000M11001
10001100101110C0C00001110001
1001000010010000000111000001
10000111000C0000000101100001
101C00C0001010C00011C1010011
1CE010110C00C0100000001000C1
1010010001000000000010000011
1111111111111111111111111111