111111111111111111111111111111111111
1C1100000C10111110C00000000001001101
100100010111000110000100101CC1010001
100100100001101010001100000000010M01
1001000000100000100100101C1C00100111
100100C101C001001C001001010011001011
10010000001111000010100000111C010001
110000001C01111101100000000C0MC00011
110C11100110100010000000001010011001
1010M000C010001100010101000011000M01
100100001000010000010C010011000C1001
100111P01000010000010000000000000111
101100000000100001000100101010010011
11001C0000010C01101001E0000101011101
110C00C1000001010M0000C1100011101011
100110101010C11000000100010001000001
101100010000010001101000010110011101
110100010001110111010010100111101001
101001010000C100000101000010110100C1
101100000010001011000000000000001011
100000000011001001001000000001000001
11001111001010C010000001C00101100001
100101010000110010010110001100100001
110000000000110000000100010001000001
110000100010001001101100010M11001011
100110010C001001000111000010C0010001
100001C1010100C0100000M0000000001001
100001000000011001000111000101C00101
10000C00001110M010C01010000000C11001
1000100101001001000C1100C00000010001
100100101100100100C01000000101000001
1110001010001111001100M1C00011000C01
11010110000110M00C000001C10000100001
111111111111111111111111111111111111