1111111111111111111111111
10000M0000011010001000C01
1000110111000010001011101
101011C01C001C00000100101
1010001011110001000000001
10C0000101000100100000101
110000011000011C010001011
1001110000000000000000101
1100100000100000001010011
1010101001111C0C0011M1001
1C01011000M100000M0100101
111110C011000C00001010101
111C000000001100000000101
1101000011110000000010001
1000100011000111000101C11
1M01100001100001001C00001
1000010101100110010010011
1010001010000C01010000011
110101C000C01000110011001
1010C01100000101110000011
110010000010100010C111101
1110110011010010100011101
1000001010100101010001111
100011010001010001C100C01
10000000010M0110001010011
10000010011001C1000011101
1C00000000100011011001001
1001000010000101001110011
1100000010000010001000111
1010100101000C00010000101
100011010C000C10000011101
100000100000P01M011000011
1100010001000100000000001
10110000000C00000010C0001
1000000011101100100000001
101100C010100C00001000011
100C0M00110100100CC110001
100001000001100100000E111
1111111111111111111111111