11111111111111111111111111111111111111111111
1C0001010C100000C010001000101000000000011C01
101011001100100000010000101000C010M100010001
100C100C0C0000001010000001001010000000111001
100000001000000000M0000111000100000010100001
10000100000100110000000001100010100011000101
110001001001010001000000000000C1000010000001
100100100000C1000000C11010011000010100000001
1010000101011000010000000000010C001000001001
10010000C1C1001010100100011M0000C0CC010M1101
1C01100010001110000001001C10P100000100010101
11C0010001010100C0000000001C0101010101110011
100000000100000M0001101000000100001010000011
1C00C0C0000100100010100100101M11000000001001
1010000000000010001011C00001000000001000C101
1000101C010100100100010001010100101100000001
10010001000000000000010000101000010001000101
111000000001000000000C0101010001010000M00001
10001000C00110000010000001C00000110010000001
1000001C10000000000C00000000101100011100C011
100000100001000000101000000C0000000010000011
11100011000010100000C1000M001100000000000011
1100101011010001001101101000001010M010010001
10011010010000000100100000001C01C00000100111
1110101100000C11000101011000001010001000M011
100101000000010100C0001000001010110000000001
1000C00100000000000111100000011000C001C00001
10100001101100001000011000010M001000C0C01101
10101110100010001C00100101000000000100000011
10000001100100110101011000000010011010C01C01
10010010001000100100100111010000001110011101
10000000M0010101C001000100010000011101C00111
10000000100100110001010000001C10110101000111
10000000100000000000110100000000100001000111
1000000011010000110000000000101100C10000C0C1
11C00C10000100100100000000010011001000101101
101111010000000000100100101001C0110000100011
10001000010C0C00000100C001011010000001110101
1001101010000C00010000E0100010010M0C00000101
1010M001010000000000000110000000000000100011
10100101000100100100001010001100000100000001
101010000001C011001C01011C0001101C0000011C01
1000000M00000100100100C010C0C00001M0C0000001
10100000000000001001110010010000010000000101
11111111111111111111111111111111111111111111