11111111111111111111111111111111
100M10110000000C0000010110011011
110100100101111100C0001000011001
1001111011M0C1110001100001001001
11011110001101000111100C11000001
10110111C00010101000001000100001
10101001100001011M00001010001011
11000010001110011100000000C00001
1011C100011001010001010011001001
10101000001101010000000000110101
100C0C100000000001C0001010000001
1000000C000001001001000000001M01
110010000000000C0C00000010110001
110C001111000000100000101000C011
110100100001011010000001010011C1
110P1101100001010010001001001101
10000C0C0000110000000000100C0001
10001C1110010000100000110C000001
1011000010101001C000100011000011
10100000000001000010010100001011
10000000010010010001010000100001
111010000010100C1M001C01M0000C01
10110100000000C100CE010101011011
11010000010100010000100110011011
11111111111111111111111111111111