1111111
1110101
1000011
100E001
1001011
1010011
10001C1
1100001
1P00001
1111111