111111111111111111111111111111111111
100011001100100001000C1101001C000101
1000010010101001100C001100001000C011
10111100100000000001001000111C000011
110011101000000001101010000010011001
110000C0C001000010000000000100011001
11010M0000010010CM10000001001C100001
111001000001101E01001000010000010001
1000000110101100000001110100010P1C01
11C0C1100011C000C1000100000000010011
100101100010001000000000100010000001
1010000C010C0C01100000000MC10C0000C1
1011001000010001001011011C00C0100001
110000110100010001111000010010110011
101100110110000000100001000C111001M1
100100100C10100000C00000000010010011
100011110000C0C0000000C0000100000111
1100110M0110000C11110110000001000111
110111000100001001C00111000000001111
10011C100011001100011110011010110001
100000110110010C00101000100011000C11
10101011110011C0C1000010010100101001
10100000000M0100000110C001M100010001
100000010101000001M00100010011011111
101000000001000010000000100100000001
100101110111100110001001101110000001
1C001C101001000001100010011010110011
10100011100001101001001000C010100001
10001100000C010110101000100001M00101
1100000000010C0C00011101100001000001
100000000100000000011010010100000011
100010000000001010001000010M00100011
111111111111111111111111111111111111